##############
#@....#......#
#....##......#
#............#
#....####....#
#.....#......#
#......#.....#
#.....##.##..#
#......#.....#
#......#.....#
#.....#......#
#....###.....#
#..........O.#
##############