##############
#@...........#
#....##......#
#............#
#....##......#
#............#
#......#.....#
#.....##.##..#
#......#.....#
#......#.....#
#............#
#....###.....#
#..........O.#
##############